1111111
100E111111
10P0000001
1111111
