11111111
100E111111
10P0000001
11111111
