1111111111111
1000C00000011
1000011001011
11P011E000C01
1111111111111
